111111111111111111111111111111111111111111111111111111111111111111
111100000000000000000000000000000000000000000000000000000000000111
111100000000000000000000000000000000000000000000000000000000000001
1111E001111111110C000000000000000000000000000000000000000000000001
111100000000000000000000000000000000000000000000C00000000000000001
1111000000000C000P000000000000000000000000000000000000000000000011
111100000000000000000000000000000000000000000000000000000000000001
11110000000C000000000000000000000000000000000000C00000000000000001
111100000000000000000000000000000000000000000000000000000000000001
111111111111111111111111111111111111111111111111111111111111111111
