111111111111111111
11000000C000000001
100111111111C01111
100110000001000001
100C11P11000C00111
111111111111111111
